NO ./textures/north_texture.png
        EA ./textures/north_texture.png




WE      ./textures/north_texture.png
SO             ./textures/north_texture.png

C 42,15,9
F 65,42,6

         
11111
1N011
11111111