NO ./textures/north_texture1.png
        EA ./textures/east_texture1.png




WE      ./textures/west_texture1.png
SO             ./textures/south_texture1.png

C 255,0,0

F 0,0,255

        
11111
1N011
11111111