NO textures/N.xpm
SO textures/S.xpm
WE textures/W.xpm
EA textures/E.xpm
F 184,113,39
C 51,198,227
        11111111111111111111111
        10000000001100000000001
        10110000011100000000001
        10010000000000000000001
        10110000011100000000001
        10000000001100000111011
        11110111111111011100001
        11110111111111011101011
        11000000110101011100001
        10000000000000001100001
        10000000000000001101011
        11000000110101000000001
        11110111110101000000001
        10000000001100000100001
        10000000000000001010001
        10000000001000011111111
11111111101000000N0000001
1000000100000001010000001
1111111111111111111111111
