NO ./textures/north_texture.png
        EA ./textures/north_texture.png




WE      ./textures/north_texture.png
SO             ./textures/north_texture.png

C 42,15,9
F 65,42,6

            
1111111
1N000001
111111111
111111
1111110